,Name,Type,HP,Attack,Defense,Speed Attack,Speed Defense,Speed,Total
0,Bulbasaur,GRASS;POISON,45,49,49,65,65,45,318
1,Ivysaur,GRASS;POISON,60,62,63,80,80,60,405
2,Venusaur,GRASS;POISON,80,82,83,100,100,80,525
3,Venusaur,GRASS;POISON,80,100,123,122,120,80,625
4,Charmander,FIRE,39,52,43,60,50,65,309
5,Charmeleon,FIRE,58,64,58,80,65,80,405
6,Charizard,FIRE;FLYING,78,84,78,109,85,100,534
7,Charizard,FIRE;DRAGON,78,130,111,130,85,100,634
8,Charizard,FIRE;FLYING,78,104,78,159,115,100,634
9,Squirtle,WATER,44,48,65,50,64,43,314
10,Wartortle,WATER,59,63,80,65,80,58,405
11,Blastoise,WATER,79,83,100,85,105,78,530
12,Blastoise,WATER,79,103,120,135,115,78,630
13,Caterpie,BUG,45,30,35,20,20,45,195
14,Metapod,BUG,50,20,55,25,25,30,205
15,Butterfree,BUG;FLYING,60,45,50,90,80,70,395
16,Weedle,BUG;POISON,40,35,30,20,20,50,195
17,Kakuna,BUG;POISON,45,25,50,25,25,35,205
18,Beedrill,BUG;POISON,65,90,40,45,80,75,395
19,Beedrill,BUG;POISON,65,150,40,15,80,145,495
20,Pidgey,NORMAL;FLYING,40,45,40,35,35,56,251
21,Pidgeotto,NORMAL;FLYING,63,60,55,50,50,71,349
22,Pidgeot,NORMAL;FLYING,83,80,75,70,70,101,479
23,Pidgeot,NORMAL;FLYING,83,80,80,135,80,121,579
24,Rattata,NORMAL,30,56,35,25,35,72,253
25,Rattata,DARK;NORMAL,30,56,35,25,35,72,253
26,Raticate,NORMAL,55,81,60,50,70,97,413
27,Raticate,DARK;NORMAL,75,71,70,40,80,77,413
28,Spearow,NORMAL;FLYING,40,60,30,31,31,70,262
29,Fearow,NORMAL;FLYING,65,90,65,61,61,100,442
30,Ekans,POISON,35,60,44,40,54,55,288
31,Arbok,POISON,60,95,69,65,79,80,448
32,Pikachu,ELECTRIC,35,55,40,50,50,90,320
33,Pikachu,ELECTRIC,45,80,50,75,60,120,430
34,Raichu,ELECTRIC,60,90,55,90,80,110,485
35,Raichu,ELECTRIC;PSYCHIC,60,85,50,95,85,110,485
36,Sandshrew,GROUND,50,75,85,20,30,40,300
37,Sandshrew,ICE;STEEL,50,75,90,10,35,40,300
38,Sandslash,GROUND,75,100,110,45,55,65,450
39,Sandslash,ICE;STEEL,75,100,120,25,65,65,450
40,Nidoran♀,POISON,55,47,52,40,40,41,275
41,Nidorina,POISON,70,62,67,55,55,56,365
42,Nidoqueen,POISON;GROUND,90,92,87,75,85,76,505
43,Nidoran♂,POISON,46,57,40,40,40,50,273
44,Nidorino,POISON,61,72,57,55,55,65,365
45,Nidoking,POISON;GROUND,81,102,77,85,75,85,505
46,Clefairy,FAIRY,70,45,48,60,65,35,323
47,Clefable,FAIRY,95,70,73,95,90,60,483
48,Vulpix,FIRE,38,41,40,50,65,65,299
49,Vulpix,ICE,38,41,40,50,65,65,299
50,Ninetales,FIRE,73,76,75,81,100,100,505
51,Ninetales,ICE;FAIRY,73,67,75,81,100,109,505
52,Jigglypuff,NORMAL;FAIRY,115,45,20,45,25,20,270
53,Wigglytuff,NORMAL;FAIRY,140,70,45,85,50,45,435
54,Zubat,POISON;FLYING,40,45,35,30,40,55,245
55,Golbat,POISON;FLYING,75,80,70,65,75,90,455
56,Oddish,GRASS;POISON,45,50,55,75,65,30,320
57,Gloom,GRASS;POISON,60,65,70,85,75,40,395
58,Vileplume,GRASS;POISON,75,80,85,110,90,50,490
59,Paras,BUG;GRASS,35,70,55,45,55,25,285
60,Parasect,BUG;GRASS,60,95,80,60,80,30,405
61,Venonat,BUG;POISON,60,55,50,40,55,45,305
62,Venomoth,BUG;POISON,70,65,60,90,75,90,450
63,Diglett,GROUND,10,55,25,35,45,95,265
64,Diglett,GROUND;STEEL,10,55,30,35,45,90,265
65,Dugtrio,GROUND,35,100,50,50,70,120,425
66,Dugtrio,GROUND;STEEL,35,100,60,50,70,110,425
67,Meowth,NORMAL,40,45,35,40,40,90,290
68,Meowth,DARK,40,35,35,50,40,90,290
69,Meowth,STEEL,50,65,55,40,40,40,290
70,Persian,NORMAL,65,70,60,65,65,115,440
71,Persian,DARK,65,60,60,75,65,115,440
72,Psyduck,WATER,50,52,48,65,50,55,320
73,Golduck,WATER,80,82,78,95,80,85,500
74,Mankey,FIGHTING,40,80,35,35,45,70,305
75,Primeape,FIGHTING,65,105,60,60,70,95,455
76,Growlithe,FIRE,55,70,45,70,50,60,350
77,Arcanine,FIRE,90,110,80,100,80,95,555
78,Poliwag,WATER,40,50,40,40,40,90,300
79,Poliwhirl,WATER,65,65,65,50,50,90,385
80,Poliwrath,WATER;FIGHTING,90,95,95,70,90,70,510
81,Abra,PSYCHIC,25,20,15,105,55,90,310
82,Kadabra,PSYCHIC,40,35,30,120,70,105,400
83,Alakazam,PSYCHIC,55,50,45,135,95,120,500
84,Alakazam,PSYCHIC,55,50,65,175,105,150,600
85,Machop,FIGHTING,70,80,50,35,35,35,305
86,Machoke,FIGHTING,80,100,70,50,60,45,405
87,Machamp,FIGHTING,90,130,80,65,85,55,505
88,Bellsprout,GRASS;POISON,50,75,35,70,30,40,300
89,Weepinbell,GRASS;POISON,65,90,50,85,45,55,390
90,Victreebel,GRASS;POISON,80,105,65,100,70,70,490
91,Tentacool,WATER;POISON,40,40,35,50,100,70,335
92,Tentacruel,WATER;POISON,80,70,65,80,120,100,515
93,Geodude,ROCK;GROUND,40,80,100,30,30,20,300
94,Geodude,ROCK;ELECTRIC,40,80,100,30,30,20,300
95,Graveler,ROCK;GROUND,55,95,115,45,45,35,390
96,Graveler,ROCK;ELECTRIC,55,95,115,45,45,35,390
97,Golem,ROCK;GROUND,80,120,130,55,65,45,495
98,Golem,ROCK;ELECTRIC,80,120,130,55,65,45,495
99,Ponyta,FIRE,50,85,55,65,65,90,410
100,Ponyta,PSYCHIC,50,85,55,65,65,90,410
101,Rapidash,FIRE,65,100,70,80,80,105,500
102,Rapidash,PSYCHIC;FAIRY,65,100,70,80,80,105,500
103,Slowpoke,WATER;PSYCHIC,90,65,65,40,40,15,315
104,Slowpoke,PSYCHIC,90,65,65,40,40,15,315
105,Slowbro,WATER;PSYCHIC,95,75,110,100,80,30,490
106,Slowbro,WATER;PSYCHIC,95,75,180,130,80,30,590
107,Slowbro,POISON;PSYCHIC,95,100,95,100,70,30,490
108,Magnemite,ELECTRIC;STEEL,25,35,70,95,55,45,325
109,Magneton,ELECTRIC;STEEL,50,60,95,120,70,70,465
110,Farfetch'd,NORMAL;FLYING,52,90,55,58,62,60,377
111,Farfetch'd,FIGHTING,52,95,55,58,62,55,377
112,Doduo,NORMAL;FLYING,35,85,45,35,35,75,310
113,Dodrio,NORMAL;FLYING,60,110,70,60,60,110,470
114,Seel,WATER,65,45,55,45,70,45,325
115,Dewgong,WATER;ICE,90,70,80,70,95,70,475
116,Grimer,POISON,80,80,50,40,50,25,325
117,Grimer,POISON;DARK,80,80,50,40,50,25,325
118,Muk,POISON,105,105,75,65,100,50,500
119,Muk,POISON;DARK,105,105,75,65,100,50,500
120,Shellder,WATER,30,65,100,45,25,40,305
121,Cloyster,WATER;ICE,50,95,180,85,45,70,525
122,Gastly,GHOST;POISON,30,35,30,100,35,80,310
123,Haunter,GHOST;POISON,45,50,45,115,55,95,405
124,Gengar,GHOST;POISON,60,65,60,130,75,110,500
125,Gengar,GHOST;POISON,60,65,80,170,95,130,600
126,Onix,ROCK;GROUND,35,45,160,30,45,70,385
127,Drowzee,PSYCHIC,60,48,45,43,90,42,328
128,Hypno,PSYCHIC,85,73,70,73,115,67,483
129,Krabby,WATER,30,105,90,25,25,50,325
130,Kingler,WATER,55,130,115,50,50,75,475
131,Voltorb,ELECTRIC,40,30,50,55,55,100,330
132,Electrode,ELECTRIC,60,50,70,80,80,150,490
133,Exeggcute,GRASS;PSYCHIC,60,40,80,60,45,40,325
134,Exeggutor,GRASS;PSYCHIC,95,95,85,125,75,55,530
135,Exeggutor,GRASS;DRAGON,95,105,85,125,75,45,530
136,Cubone,GROUND,50,50,95,40,50,35,320
137,Marowak,GROUND,60,80,110,50,80,45,425
138,Marowak,FIRE;GHOST,60,80,110,50,80,45,425
139,Hitmonlee,FIGHTING,50,120,53,35,110,87,455
140,Hitmonchan,FIGHTING,50,105,79,35,110,76,455
141,Lickitung,NORMAL,90,55,75,60,75,30,385
142,Koffing,POISON,40,65,95,60,45,35,340
143,Weezing,POISON,65,90,120,85,70,60,490
144,Weezing,POISON;FAIRY,65,90,120,85,70,60,490
145,Rhyhorn,GROUND;ROCK,80,85,95,30,30,25,345
146,Rhydon,GROUND;ROCK,105,130,120,45,45,40,485
147,Chansey,NORMAL,250,5,5,35,105,50,450
148,Tangela,GRASS,65,55,115,100,40,60,435
149,Kangaskhan,NORMAL,105,95,80,40,80,90,490
150,Kangaskhan,NORMAL,105,125,100,60,100,100,590
151,Horsea,WATER,30,40,70,70,25,60,295
152,Seadra,WATER,55,65,95,95,45,85,440
153,Goldeen,WATER,45,67,60,35,50,63,320
154,Seaking,WATER,80,92,65,65,80,68,450
155,Staryu,WATER,30,45,55,70,55,85,340
156,Starmie,WATER;PSYCHIC,60,75,85,100,85,115,520
157,Mr. Mime,PSYCHIC;FAIRY,40,45,65,100,120,90,460
158,Mr. Mime,PSYCHIC;ICE,50,65,65,90,90,100,460
159,Scyther,BUG;FLYING,70,110,80,55,80,105,500
160,Jynx,ICE;PSYCHIC,65,50,35,115,95,95,455
161,Electabuzz,ELECTRIC,65,83,57,95,85,105,490
162,Magmar,FIRE,65,95,57,100,85,93,495
163,Pinsir,BUG,65,125,100,55,70,85,500
164,Pinsir,BUG;FLYING,65,155,120,65,90,105,600
165,Tauros,NORMAL,75,100,95,40,70,110,490
166,Magikarp,WATER,20,10,55,15,20,80,200
167,Gyarados,WATER;FLYING,95,125,79,60,100,81,540
168,Gyarados,WATER;DARK,95,155,109,70,130,81,640
169,Lapras,WATER;ICE,130,85,80,85,95,60,535
170,Ditto,NORMAL,48,48,48,48,48,48,288
171,Eevee,NORMAL,55,55,50,45,65,55,325
172,Eevee,NORMAL,65,75,70,65,85,75,435
173,Vaporeon,WATER,130,65,60,110,95,65,525
174,Jolteon,ELECTRIC,65,65,60,110,95,130,525
175,Flareon,FIRE,65,130,60,95,110,65,525
176,Porygon,NORMAL,65,60,70,85,75,40,395
177,Omanyte,ROCK;WATER,35,40,100,90,55,35,355
178,Omastar,ROCK;WATER,70,60,125,115,70,55,495
179,Kabuto,ROCK;WATER,30,80,90,55,45,55,355
180,Kabutops,ROCK;WATER,60,115,105,65,70,80,495
181,Aerodactyl,ROCK;FLYING,80,105,65,60,75,130,515
182,Aerodactyl,ROCK;FLYING,80,135,85,70,95,150,615
183,Snorlax,NORMAL,160,110,65,65,110,30,540
184,Articuno,ICE;FLYING,90,85,100,95,125,85,580
185,Articuno,PSYCHIC;FLYING,90,85,85,125,100,95,580
186,Zapdos,ELECTRIC;FLYING,90,90,85,125,90,100,580
187,Zapdos,FIGHTING;FLYING,90,125,90,85,90,100,580
188,Moltres,FIRE;FLYING,90,100,90,125,85,90,580
189,Moltres,DARK;FLYING,90,85,90,100,125,90,580
190,Dratini,DRAGON,41,64,45,50,50,50,300
191,Dragonair,DRAGON,61,84,65,70,70,70,420
192,Dragonite,DRAGON;FLYING,91,134,95,100,100,80,600
193,Mewtwo,PSYCHIC,106,110,90,154,90,130,680
194,Mewtwo,PSYCHIC;FIGHTING,106,190,100,154,100,130,780
195,Mewtwo,PSYCHIC,106,150,70,194,120,140,780
196,Mew,PSYCHIC,100,100,100,100,100,100,600
197,Chikorita,GRASS,45,49,65,49,65,45,318
198,Bayleef,GRASS,60,62,80,63,80,60,405
199,Meganium,GRASS,80,82,100,83,100,80,525
200,Cyndaquil,FIRE,39,52,43,60,50,65,309
201,Quilava,FIRE,58,64,58,80,65,80,405
202,Typhlosion,FIRE,78,84,78,109,85,100,534
203,Totodile,WATER,50,65,64,44,48,43,314
204,Croconaw,WATER,65,80,80,59,63,58,405
205,Feraligatr,WATER,85,105,100,79,83,78,530
206,Sentret,NORMAL,35,46,34,35,45,20,215
207,Furret,NORMAL,85,76,64,45,55,90,415
208,Hoothoot,NORMAL;FLYING,60,30,30,36,56,50,262
209,Noctowl,NORMAL;FLYING,100,50,50,86,96,70,452
210,Ledyba,BUG;FLYING,40,20,30,40,80,55,265
211,Ledian,BUG;FLYING,55,35,50,55,110,85,390
212,Spinarak,BUG;POISON,40,60,40,40,40,30,250
213,Ariados,BUG;POISON,70,90,70,60,70,40,400
214,Crobat,POISON;FLYING,85,90,80,70,80,130,535
215,Chinchou,WATER;ELECTRIC,75,38,38,56,56,67,330
216,Lanturn,WATER;ELECTRIC,125,58,58,76,76,67,460
217,Pichu,ELECTRIC,20,40,15,35,35,60,205
218,Cleffa,FAIRY,50,25,28,45,55,15,218
219,Igglybuff,NORMAL;FAIRY,90,30,15,40,20,15,210
220,Togepi,FAIRY,35,20,65,40,65,20,245
221,Togetic,FAIRY;FLYING,55,40,85,80,105,40,405
222,Natu,PSYCHIC;FLYING,40,50,45,70,45,70,320
223,Xatu,PSYCHIC;FLYING,65,75,70,95,70,95,470
224,Mareep,ELECTRIC,55,40,40,65,45,35,280
225,Flaaffy,ELECTRIC,70,55,55,80,60,45,365
226,Ampharos,ELECTRIC,90,75,85,115,90,55,510
227,Ampharos,ELECTRIC;DRAGON,90,95,105,165,110,45,610
228,Bellossom,GRASS,75,80,95,90,100,50,490
229,Marill,WATER;FAIRY,70,20,50,20,50,40,250
230,Azumarill,WATER;FAIRY,100,50,80,60,80,50,420
231,Sudowoodo,ROCK,70,100,115,30,65,30,410
232,Politoed,WATER,90,75,75,90,100,70,500
233,Hoppip,GRASS;FLYING,35,35,40,35,55,50,250
234,Skiploom,GRASS;FLYING,55,45,50,45,65,80,340
235,Jumpluff,GRASS;FLYING,75,55,70,55,95,110,460
236,Aipom,NORMAL,55,70,55,40,55,85,360
237,Sunkern,GRASS,30,30,30,30,30,30,180
238,Sunflora,GRASS,75,75,55,105,85,30,425
239,Yanma,BUG;FLYING,65,65,45,75,45,95,390
240,Wooper,WATER;GROUND,55,45,45,25,25,15,210
241,Quagsire,WATER;GROUND,95,85,85,65,65,35,430
242,Espeon,PSYCHIC,65,65,60,130,95,110,525
243,Umbreon,DARK,95,65,110,60,130,65,525
244,Murkrow,DARK;FLYING,60,85,42,85,42,91,405
245,Slowking,WATER;PSYCHIC,95,75,80,100,110,30,490
246,Slowking,POISON;PSYCHIC,95,65,80,110,110,30,490
247,Misdreavus,GHOST,60,60,60,85,85,85,435
248,Unown,PSYCHIC,48,72,48,72,48,48,336
249,Wobbuffet,PSYCHIC,190,33,58,33,58,33,405
250,Girafarig,NORMAL;PSYCHIC,70,80,65,90,65,85,455
251,Pineco,BUG,50,65,90,35,35,15,290
252,Forretress,BUG;STEEL,75,90,140,60,60,40,465
253,Dunsparce,NORMAL,100,70,70,65,65,45,415
254,Gligar,GROUND;FLYING,65,75,105,35,65,85,430
255,Steelix,STEEL;GROUND,75,85,200,55,65,30,510
256,Steelix,STEEL;GROUND,75,125,230,55,95,30,610
257,Snubbull,FAIRY,60,80,50,40,40,30,300
258,Granbull,FAIRY,90,120,75,60,60,45,450
259,Qwilfish,WATER;POISON,65,95,85,55,55,85,440
260,Scizor,BUG;STEEL,70,130,100,55,80,65,500
261,Scizor,BUG;STEEL,70,150,140,65,100,75,600
262,Shuckle,BUG;ROCK,20,10,230,10,230,5,505
263,Heracross,BUG;FIGHTING,80,125,75,40,95,85,500
264,Heracross,BUG;FIGHTING,80,185,115,40,105,75,600
265,Sneasel,DARK;ICE,55,95,55,35,75,115,430
266,Teddiursa,NORMAL,60,80,50,50,50,40,330
267,Ursaring,NORMAL,90,130,75,75,75,55,500
268,Slugma,FIRE,40,40,40,70,40,20,250
269,Magcargo,FIRE;ROCK,60,50,120,90,80,30,430
270,Swinub,ICE;GROUND,50,50,40,30,30,50,250
271,Piloswine,ICE;GROUND,100,100,80,60,60,50,450
272,Corsola,WATER;ROCK,65,55,95,65,95,35,410
273,Corsola,GHOST,60,55,100,65,100,30,410
274,Remoraid,WATER,35,65,35,65,35,65,300
275,Octillery,WATER,75,105,75,105,75,45,480
276,Delibird,ICE;FLYING,45,55,45,65,45,75,330
277,Mantine,WATER;FLYING,85,40,70,80,140,70,485
278,Skarmory,STEEL;FLYING,65,80,140,40,70,70,465
279,Houndour,DARK;FIRE,45,60,30,80,50,65,330
280,Houndoom,DARK;FIRE,75,90,50,110,80,95,500
281,Houndoom,DARK;FIRE,75,90,90,140,90,115,600
282,Kingdra,WATER;DRAGON,75,95,95,95,95,85,540
283,Phanpy,GROUND,90,60,60,40,40,40,330
284,Donphan,GROUND,90,120,120,60,60,50,500
285,Porygon2,NORMAL,85,80,90,105,95,60,515
286,Stantler,NORMAL,73,95,62,85,65,85,465
287,Smeargle,NORMAL,55,20,35,20,45,75,250
288,Tyrogue,FIGHTING,35,35,35,35,35,35,210
289,Hitmontop,FIGHTING,50,95,95,35,110,70,455
290,Smoochum,ICE;PSYCHIC,45,30,15,85,65,65,305
291,Elekid,ELECTRIC,45,63,37,65,55,95,360
292,Magby,FIRE,45,75,37,70,55,83,365
293,Miltank,NORMAL,95,80,105,40,70,100,490
294,Blissey,NORMAL,255,10,10,75,135,55,540
295,Raikou,ELECTRIC,90,85,75,115,100,115,580
296,Entei,FIRE,115,115,85,90,75,100,580
297,Suicune,WATER,100,75,115,90,115,85,580
298,Larvitar,ROCK;GROUND,50,64,50,45,50,41,300
299,Pupitar,ROCK;GROUND,70,84,70,65,70,51,410
300,Tyranitar,ROCK;DARK,100,134,110,95,100,61,600
301,Tyranitar,ROCK;DARK,100,164,150,95,120,71,700
302,Lugia,PSYCHIC;FLYING,106,90,130,90,154,110,680
303,Ho-oh,FIRE;FLYING,106,130,90,110,154,90,680
304,Celebi,PSYCHIC;GRASS,100,100,100,100,100,100,600
305,Treecko,GRASS,40,45,35,65,55,70,310
306,Grovyle,GRASS,50,65,45,85,65,95,405
307,Sceptile,GRASS,70,85,65,105,85,120,530
308,Sceptile,GRASS;DRAGON,70,110,75,145,85,145,630
309,Torchic,FIRE,45,60,40,70,50,45,310
310,Combusken,FIRE;FIGHTING,60,85,60,85,60,55,405
311,Blaziken,FIRE;FIGHTING,80,120,70,110,70,80,530
312,Blaziken,FIRE;FIGHTING,80,160,80,130,80,100,630
313,Mudkip,WATER,50,70,50,50,50,40,310
314,Marshtomp,WATER;GROUND,70,85,70,60,70,50,405
315,Swampert,WATER;GROUND,100,110,90,85,90,60,535
316,Swampert,WATER;GROUND,100,150,110,95,110,70,635
317,Poochyena,DARK,35,55,35,30,30,35,220
318,Mightyena,DARK,70,90,70,60,60,70,420
319,Zigzagoon,NORMAL,38,30,41,30,41,60,240
320,Zigzagoon,DARK;NORMAL,38,30,41,30,41,60,240
321,Linoone,NORMAL,78,70,61,50,61,100,420
322,Linoone,DARK;NORMAL,78,70,61,50,61,100,420
323,Wurmple,BUG,45,45,35,20,30,20,195
324,Silcoon,BUG,50,35,55,25,25,15,205
325,Beautifly,BUG;FLYING,60,70,50,100,50,65,395
326,Cascoon,BUG,50,35,55,25,25,15,205
327,Dustox,BUG;POISON,60,50,70,50,90,65,385
328,Lotad,WATER;GRASS,40,30,30,40,50,30,220
329,Lombre,WATER;GRASS,60,50,50,60,70,50,340
330,Ludicolo,WATER;GRASS,80,70,70,90,100,70,480
331,Seedot,GRASS,40,40,50,30,30,30,220
332,Nuzleaf,GRASS;DARK,70,70,40,60,40,60,340
333,Shiftry,GRASS;DARK,90,100,60,90,60,80,480
334,Taillow,NORMAL;FLYING,40,55,30,30,30,85,270
335,Swellow,NORMAL;FLYING,60,85,60,75,50,125,455
336,Wingull,WATER;FLYING,40,30,30,55,30,85,270
337,Pelipper,WATER;FLYING,60,50,100,95,70,65,440
338,Ralts,PSYCHIC;FAIRY,28,25,25,45,35,40,198
339,Kirlia,PSYCHIC;FAIRY,38,35,35,65,55,50,278
340,Gardevoir,PSYCHIC;FAIRY,68,65,65,125,115,80,518
341,Gardevoir,PSYCHIC;FAIRY,68,85,65,165,135,100,618
342,Surskit,BUG;WATER,40,30,32,50,52,65,269
343,Masquerain,BUG;FLYING,70,60,62,100,82,80,454
344,Shroomish,GRASS,60,40,60,40,60,35,295
345,Breloom,GRASS;FIGHTING,60,130,80,60,60,70,460
346,Slakoth,NORMAL,60,60,60,35,35,30,280
347,Vigoroth,NORMAL,80,80,80,55,55,90,440
348,Slaking,NORMAL,150,160,100,95,65,100,670
349,Nincada,BUG;GROUND,31,45,90,30,30,40,266
350,Ninjask,BUG;FLYING,61,90,45,50,50,160,456
351,Shedinja,BUG;GHOST,1,90,45,30,30,40,236
352,Whismur,NORMAL,64,51,23,51,23,28,240
353,Loudred,NORMAL,84,71,43,71,43,48,360
354,Exploud,NORMAL,104,91,63,91,73,68,490
355,Makuhita,FIGHTING,72,60,30,20,30,25,237
356,Hariyama,FIGHTING,144,120,60,40,60,50,474
357,Azurill,NORMAL;FAIRY,50,20,40,20,40,20,190
358,Nosepass,ROCK,30,45,135,45,90,30,375
359,Skitty,NORMAL,50,45,45,35,35,50,260
360,Delcatty,NORMAL,70,65,65,55,55,90,400
361,Sableye,DARK;GHOST,50,75,75,65,65,50,380
362,Sableye,DARK;GHOST,50,85,125,85,115,20,480
363,Mawile,STEEL;FAIRY,50,85,85,55,55,50,380
364,Mawile,STEEL;FAIRY,50,105,125,55,95,50,480
365,Aron,STEEL;ROCK,50,70,100,40,40,30,330
366,Lairon,STEEL;ROCK,60,90,140,50,50,40,430
367,Aggron,STEEL;ROCK,70,110,180,60,60,50,530
368,Aggron,STEEL,70,140,230,60,80,50,630
369,Meditite,FIGHTING;PSYCHIC,30,40,55,40,55,60,280
370,Medicham,FIGHTING;PSYCHIC,60,60,75,60,75,80,410
371,Medicham,FIGHTING;PSYCHIC,60,100,85,80,85,100,510
372,Electrike,ELECTRIC,40,45,40,65,40,65,295
373,Manectric,ELECTRIC,70,75,60,105,60,105,475
374,Manectric,ELECTRIC,70,75,80,135,80,135,575
375,Plusle,ELECTRIC,60,50,40,85,75,95,405
376,Minun,ELECTRIC,60,40,50,75,85,95,405
377,Volbeat,BUG,65,73,75,47,85,85,430
378,Illumise,BUG,65,47,75,73,85,85,430
379,Roselia,GRASS;POISON,50,60,45,100,80,65,400
380,Gulpin,POISON,70,43,53,43,53,40,302
381,Swalot,POISON,100,73,83,73,83,55,467
382,Carvanha,WATER;DARK,45,90,20,65,20,65,305
383,Sharpedo,WATER;DARK,70,120,40,95,40,95,460
384,Sharpedo,WATER;DARK,70,140,70,110,65,105,560
385,Wailmer,WATER,130,70,35,70,35,60,400
386,Wailord,WATER,170,90,45,90,45,60,500
387,Numel,FIRE;GROUND,60,60,40,65,45,35,305
388,Camerupt,FIRE;GROUND,70,100,70,105,75,40,460
389,Camerupt,FIRE;GROUND,70,120,100,145,105,20,560
390,Torkoal,FIRE,70,85,140,85,70,20,470
391,Spoink,PSYCHIC,60,25,35,70,80,60,330
392,Grumpig,PSYCHIC,80,45,65,90,110,80,470
393,Spinda,NORMAL,60,60,60,60,60,60,360
394,Trapinch,GROUND,45,100,45,45,45,10,290
395,Vibrava,GROUND;DRAGON,50,70,50,50,50,70,340
396,Flygon,GROUND;DRAGON,80,100,80,80,80,100,520
397,Cacnea,GRASS,50,85,40,85,40,35,335
398,Cacturne,GRASS;DARK,70,115,60,115,60,55,475
399,Swablu,NORMAL;FLYING,45,40,60,40,75,50,310
400,Altaria,DRAGON;FLYING,75,70,90,70,105,80,490
401,Altaria,DRAGON;FAIRY,75,110,110,110,105,80,590
402,Zangoose,NORMAL,73,115,60,60,60,90,458
403,Seviper,POISON,73,100,60,100,60,65,458
404,Lunatone,ROCK;PSYCHIC,90,55,65,95,85,70,460
405,Solrock,ROCK;PSYCHIC,90,95,85,55,65,70,460
406,Barboach,WATER;GROUND,50,48,43,46,41,60,288
407,Whiscash,WATER;GROUND,110,78,73,76,71,60,468
408,Corphish,WATER,43,80,65,50,35,35,308
409,Crawdaunt,WATER;DARK,63,120,85,90,55,55,468
410,Baltoy,GROUND;PSYCHIC,40,40,55,40,70,55,300
411,Claydol,GROUND;PSYCHIC,60,70,105,70,120,75,500
412,Lileep,ROCK;GRASS,66,41,77,61,87,23,355
413,Cradily,ROCK;GRASS,86,81,97,81,107,43,495
414,Anorith,ROCK;BUG,45,95,50,40,50,75,355
415,Armaldo,ROCK;BUG,75,125,100,70,80,45,495
416,Feebas,WATER,20,15,20,10,55,80,200
417,Milotic,WATER,95,60,79,100,125,81,540
418,Castform,NORMAL,70,70,70,70,70,70,420
419,Castform,FIRE,70,70,70,70,70,70,420
420,Castform,WATER,70,70,70,70,70,70,420
421,Castform,ICE,70,70,70,70,70,70,420
422,Kecleon,NORMAL,60,90,70,60,120,40,440
423,Shuppet,GHOST,44,75,35,63,33,45,295
424,Banette,GHOST,64,115,65,83,63,65,455
425,Banette,GHOST,64,165,75,93,83,75,555
426,Duskull,GHOST,20,40,90,30,90,25,295
427,Dusclops,GHOST,40,70,130,60,130,25,455
428,Tropius,GRASS;FLYING,99,68,83,72,87,51,460
429,Chimecho,PSYCHIC,75,50,80,95,90,65,455
430,Absol,DARK,65,130,60,75,60,75,465
431,Absol,DARK,65,150,60,115,60,115,565
432,Wynaut,PSYCHIC,95,23,48,23,48,23,260
433,Snorunt,ICE,50,50,50,50,50,50,300
434,Glalie,ICE,80,80,80,80,80,80,480
435,Glalie,ICE,80,120,80,120,80,100,580
436,Spheal,ICE;WATER,70,40,50,55,50,25,290
437,Sealeo,ICE;WATER,90,60,70,75,70,45,410
438,Walrein,ICE;WATER,110,80,90,95,90,65,530
439,Clamperl,WATER,35,64,85,74,55,32,345
440,Huntail,WATER,55,104,105,94,75,52,485
441,Gorebyss,WATER,55,84,105,114,75,52,485
442,Relicanth,WATER;ROCK,100,90,130,45,65,55,485
443,Luvdisc,WATER,43,30,55,40,65,97,330
444,Bagon,DRAGON,45,75,60,40,30,50,300
445,Shelgon,DRAGON,65,95,100,60,50,50,420
446,Salamence,DRAGON;FLYING,95,135,80,110,80,100,600
447,Salamence,DRAGON;FLYING,95,145,130,120,90,120,700
448,Beldum,STEEL;PSYCHIC,40,55,80,35,60,30,300
449,Metang,STEEL;PSYCHIC,60,75,100,55,80,50,420
450,Metagross,STEEL;PSYCHIC,80,135,130,95,90,70,600
451,Metagross,STEEL;PSYCHIC,80,145,150,105,110,110,700
452,Regirock,ROCK,80,100,200,50,100,50,580
453,Regice,ICE,80,50,100,100,200,50,580
454,Registeel,STEEL,80,75,150,75,150,50,580
455,Latias,DRAGON;PSYCHIC,80,80,90,110,130,110,600
456,Latias,DRAGON;PSYCHIC,80,100,120,140,150,110,700
457,Latios,DRAGON;PSYCHIC,80,90,80,130,110,110,600
458,Latios,DRAGON;PSYCHIC,80,130,100,160,120,110,700
459,Kyogre,WATER,100,100,90,150,140,90,670
460,Kyogre,WATER,100,150,90,180,160,90,770
461,Groudon,GROUND,100,150,140,100,90,90,670
462,Groudon,GROUND;FIRE,100,180,160,150,90,90,770
463,Rayquaza,DRAGON;FLYING,105,150,90,150,90,95,680
464,Rayquaza,DRAGON;FLYING,105,180,100,180,100,115,780
465,Jirachi,STEEL;PSYCHIC,100,100,100,100,100,100,600
466,Deoxys,PSYCHIC,50,150,50,150,50,150,600
467,Deoxys,PSYCHIC,50,180,20,180,20,150,600
468,Deoxys,PSYCHIC,50,70,160,70,160,90,600
469,Deoxys,PSYCHIC,50,95,90,95,90,180,600
470,Turtwig,GRASS,55,68,64,45,55,31,318
471,Grotle,GRASS,75,89,85,55,65,36,405
472,Torterra,GRASS;GROUND,95,109,105,75,85,56,525
473,Chimchar,FIRE,44,58,44,58,44,61,309
474,Monferno,FIRE;FIGHTING,64,78,52,78,52,81,405
475,Infernape,FIRE;FIGHTING,76,104,71,104,71,108,534
476,Piplup,WATER,53,51,53,61,56,40,314
477,Prinplup,WATER,64,66,68,81,76,50,405
478,Empoleon,WATER;STEEL,84,86,88,111,101,60,530
479,Starly,NORMAL;FLYING,40,55,30,30,30,60,245
480,Staravia,NORMAL;FLYING,55,75,50,40,40,80,340
481,Staraptor,NORMAL;FLYING,85,120,70,50,60,100,485
482,Bidoof,NORMAL,59,45,40,35,40,31,250
483,Bibarel,NORMAL;WATER,79,85,60,55,60,71,410
484,Kricketot,BUG,37,25,41,25,41,25,194
485,Kricketune,BUG,77,85,51,55,51,65,384
486,Shinx,ELECTRIC,45,65,34,40,34,45,263
487,Luxio,ELECTRIC,60,85,49,60,49,60,363
488,Luxray,ELECTRIC,80,120,79,95,79,70,523
489,Budew,GRASS;POISON,40,30,35,50,70,55,280
490,Roserade,GRASS;POISON,60,70,65,125,105,90,515
491,Cranidos,ROCK,67,125,40,30,30,58,350
492,Rampardos,ROCK,97,165,60,65,50,58,495
493,Shieldon,ROCK;STEEL,30,42,118,42,88,30,350
494,Bastiodon,ROCK;STEEL,60,52,168,47,138,30,495
495,Burmy,BUG,40,29,45,29,45,36,224
496,Wormadam,BUG;GRASS,60,59,85,79,105,36,424
497,Wormadam,BUG;GROUND,60,79,105,59,85,36,424
498,Wormadam,BUG;STEEL,60,69,95,69,95,36,424
499,Mothim,BUG;FLYING,70,94,50,94,50,66,424
500,Combee,BUG;FLYING,30,30,42,30,42,70,244
501,Vespiquen,BUG;FLYING,70,80,102,80,102,40,474
502,Pachirisu,ELECTRIC,60,45,70,45,90,95,405
503,Buizel,WATER,55,65,35,60,30,85,330
504,Floatzel,WATER,85,105,55,85,50,115,495
505,Cherubi,GRASS,45,35,45,62,53,35,275
506,Cherrim,GRASS,70,60,70,87,78,85,450
507,Shellos,WATER,76,48,48,57,62,34,325
508,Gastrodon,WATER;GROUND,111,83,68,92,82,39,475
509,Ambipom,NORMAL,75,100,66,60,66,115,482
510,Drifloon,GHOST;FLYING,90,50,34,60,44,70,348
511,Drifblim,GHOST;FLYING,150,80,44,90,54,80,498
512,Buneary,NORMAL,55,66,44,44,56,85,350
513,Lopunny,NORMAL,65,76,84,54,96,105,480
514,Lopunny,NORMAL;FIGHTING,65,136,94,54,96,135,580
515,Mismagius,GHOST,60,60,60,105,105,105,495
516,Honchkrow,DARK;FLYING,100,125,52,105,52,71,505
517,Glameow,NORMAL,49,55,42,42,37,85,310
518,Purugly,NORMAL,71,82,64,64,59,112,452
519,Chingling,PSYCHIC,45,30,50,65,50,45,285
520,Stunky,POISON;DARK,63,63,47,41,41,74,329
521,Skuntank,POISON;DARK,103,93,67,71,61,84,479
522,Bronzor,STEEL;PSYCHIC,57,24,86,24,86,23,300
523,Bronzong,STEEL;PSYCHIC,67,89,116,79,116,33,500
524,Bonsly,ROCK,50,80,95,10,45,10,290
525,Mime Jr.,PSYCHIC;FAIRY,20,25,45,70,90,60,310
526,Happiny,NORMAL,100,5,5,15,65,30,220
527,Chatot,NORMAL;FLYING,76,65,45,92,42,91,411
528,Spiritomb,GHOST;DARK,50,92,108,92,108,35,485
529,Gible,DRAGON;GROUND,58,70,45,40,45,42,300
530,Gabite,DRAGON;GROUND,68,90,65,50,55,82,410
531,Garchomp,DRAGON;GROUND,108,130,95,80,85,102,600
532,Garchomp,DRAGON;GROUND,108,170,115,120,95,92,700
533,Munchlax,NORMAL,135,85,40,40,85,5,390
534,Riolu,FIGHTING,40,70,40,35,40,60,285
535,Lucario,FIGHTING;STEEL,70,110,70,115,70,90,525
536,Lucario,FIGHTING;STEEL,70,145,88,140,70,112,625
537,Hippopotas,GROUND,68,72,78,38,42,32,330
538,Hippowdon,GROUND,108,112,118,68,72,47,525
539,Skorupi,POISON;BUG,40,50,90,30,55,65,330
540,Drapion,POISON;DARK,70,90,110,60,75,95,500
541,Croagunk,POISON;FIGHTING,48,61,40,61,40,50,300
542,Toxicroak,POISON;FIGHTING,83,106,65,86,65,85,490
543,Carnivine,GRASS,74,100,72,90,72,46,454
544,Finneon,WATER,49,49,56,49,61,66,330
545,Lumineon,WATER,69,69,76,69,86,91,460
546,Mantyke,WATER;FLYING,45,20,50,60,120,50,345
547,Snover,GRASS;ICE,60,62,50,62,60,40,334
548,Abomasnow,GRASS;ICE,90,92,75,92,85,60,494
549,Abomasnow,GRASS;ICE,90,132,105,132,105,30,594
550,Weavile,DARK;ICE,70,120,65,45,85,125,510
551,Magnezone,ELECTRIC;STEEL,70,70,115,130,90,60,535
552,Lickilicky,NORMAL,110,85,95,80,95,50,515
553,Rhyperior,GROUND;ROCK,115,140,130,55,55,40,535
554,Tangrowth,GRASS,100,100,125,110,50,50,535
555,Electivire,ELECTRIC,75,123,67,95,85,95,540
556,Magmortar,FIRE,75,95,67,125,95,83,540
557,Togekiss,FAIRY;FLYING,85,50,95,120,115,80,545
558,Yanmega,BUG;FLYING,86,76,86,116,56,95,515
559,Leafeon,GRASS,65,110,130,60,65,95,525
560,Glaceon,ICE,65,60,110,130,95,65,525
561,Gliscor,GROUND;FLYING,75,95,125,45,75,95,510
562,Mamoswine,ICE;GROUND,110,130,80,70,60,80,530
563,Porygon-Z,NORMAL,85,80,70,135,75,90,535
564,Gallade,PSYCHIC;FIGHTING,68,125,65,65,115,80,518
565,Gallade,PSYCHIC;FIGHTING,68,165,95,65,115,110,618
566,Probopass,ROCK;STEEL,60,55,145,75,150,40,525
567,Dusknoir,GHOST,45,100,135,65,135,45,525
568,Froslass,ICE;GHOST,70,80,70,80,70,110,480
569,Rotom,ELECTRIC;GHOST,50,50,77,95,77,91,440
570,Rotom,ELECTRIC;FIRE,50,65,107,105,107,86,520
571,Rotom,ELECTRIC;WATER,50,65,107,105,107,86,520
572,Rotom,ELECTRIC;ICE,50,65,107,105,107,86,520
573,Rotom,ELECTRIC;FLYING,50,65,107,105,107,86,520
574,Rotom,ELECTRIC;GRASS,50,65,107,105,107,86,520
575,Uxie,PSYCHIC,75,75,130,75,130,95,580
576,Mesprit,PSYCHIC,80,105,105,105,105,80,580
577,Azelf,PSYCHIC,75,125,70,125,70,115,580
578,Dialga,STEEL;DRAGON,100,120,120,150,100,90,680
579,Palkia,WATER;DRAGON,90,120,100,150,120,100,680
580,Heatran,FIRE;STEEL,91,90,106,130,106,77,600
581,Regigigas,NORMAL,110,160,110,80,110,100,670
582,Giratina,GHOST;DRAGON,150,100,120,100,120,90,680
583,Giratina,GHOST;DRAGON,150,120,100,120,100,90,680
584,Cresselia,PSYCHIC,120,70,120,75,130,85,600
585,Phione,WATER,80,80,80,80,80,80,480
586,Manaphy,WATER,100,100,100,100,100,100,600
587,Darkrai,DARK,70,90,90,135,90,125,600
588,Shaymin,GRASS,100,100,100,100,100,100,600
589,Shaymin,GRASS;FLYING,100,103,75,120,75,127,600
590,Arceus,NORMAL,120,120,120,120,120,120,720
591,Victini,PSYCHIC;FIRE,100,100,100,100,100,100,600
592,Snivy,GRASS,45,45,55,45,55,63,308
593,Servine,GRASS,60,60,75,60,75,83,413
594,Serperior,GRASS,75,75,95,75,95,113,528
595,Tepig,FIRE,65,63,45,45,45,45,308
596,Pignite,FIRE;FIGHTING,90,93,55,70,55,55,418
597,Emboar,FIRE;FIGHTING,110,123,65,100,65,65,528
598,Oshawott,WATER,55,55,45,63,45,45,308
599,Dewott,WATER,75,75,60,83,60,60,413
600,Samurott,WATER,95,100,85,108,70,70,528
601,Patrat,NORMAL,45,55,39,35,39,42,255
602,Watchog,NORMAL,60,85,69,60,69,77,420
603,Lillipup,NORMAL,45,60,45,25,45,55,275
604,Herdier,NORMAL,65,80,65,35,65,60,370
605,Stoutland,NORMAL,85,110,90,45,90,80,500
606,Purrloin,DARK,41,50,37,50,37,66,281
607,Liepard,DARK,64,88,50,88,50,106,446
608,Pansage,GRASS,50,53,48,53,48,64,316
609,Simisage,GRASS,75,98,63,98,63,101,498
610,Pansear,FIRE,50,53,48,53,48,64,316
611,Simisear,FIRE,75,98,63,98,63,101,498
612,Panpour,WATER,50,53,48,53,48,64,316
613,Simipour,WATER,75,98,63,98,63,101,498
614,Munna,PSYCHIC,76,25,45,67,55,24,292
615,Musharna,PSYCHIC,116,55,85,107,95,29,487
616,Pidove,NORMAL;FLYING,50,55,50,36,30,43,264
617,Tranquill,NORMAL;FLYING,62,77,62,50,42,65,358
618,Unfezant,NORMAL;FLYING,80,115,80,65,55,93,488
619,Blitzle,ELECTRIC,45,60,32,50,32,76,295
620,Zebstrika,ELECTRIC,75,100,63,80,63,116,497
621,Roggenrola,ROCK,55,75,85,25,25,15,280
622,Boldore,ROCK,70,105,105,50,40,20,390
623,Gigalith,ROCK,85,135,130,60,80,25,515
624,Woobat,PSYCHIC;FLYING,65,45,43,55,43,72,323
625,Swoobat,PSYCHIC;FLYING,67,57,55,77,55,114,425
626,Drilbur,GROUND,60,85,40,30,45,68,328
627,Excadrill,GROUND;STEEL,110,135,60,50,65,88,508
628,Audino,NORMAL,103,60,86,60,86,50,445
629,Audino,NORMAL;FAIRY,103,60,126,80,126,50,545
630,Timburr,FIGHTING,75,80,55,25,35,35,305
631,Gurdurr,FIGHTING,85,105,85,40,50,40,405
632,Conkeldurr,FIGHTING,105,140,95,55,65,45,505
633,Tympole,WATER,50,50,40,50,40,64,294
634,Palpitoad,WATER;GROUND,75,65,55,65,55,69,384
635,Seismitoad,WATER;GROUND,105,95,75,85,75,74,509
636,Throh,FIGHTING,120,100,85,30,85,45,465
637,Sawk,FIGHTING,75,125,75,30,75,85,465
638,Sewaddle,BUG;GRASS,45,53,70,40,60,42,310
639,Swadloon,BUG;GRASS,55,63,90,50,80,42,380
640,Leavanny,BUG;GRASS,75,103,80,70,80,92,500
641,Venipede,BUG;POISON,30,45,59,30,39,57,260
642,Whirlipede,BUG;POISON,40,55,99,40,79,47,360
643,Scolipede,BUG;POISON,60,100,89,55,69,112,485
644,Cottonee,GRASS;FAIRY,40,27,60,37,50,66,280
645,Whimsicott,GRASS;FAIRY,60,67,85,77,75,116,480
646,Petilil,GRASS,45,35,50,70,50,30,280
647,Lilligant,GRASS,70,60,75,110,75,90,480
648,Basculin,WATER,70,92,65,80,55,98,460
649,Basculin,WATER,70,92,65,80,55,98,460
650,Sandile,GROUND;DARK,50,72,35,35,35,65,292
651,Krokorok,GROUND;DARK,60,82,45,45,45,74,351
652,Krookodile,GROUND;DARK,95,117,80,65,70,92,519
653,Darumaka,FIRE,70,90,45,15,45,50,315
654,Darumaka,ICE,70,90,45,15,45,50,315
655,Darmanitan,FIRE,105,140,55,30,55,95,480
656,Darmanitan,FIRE;PSYCHIC,105,30,105,140,105,55,540
657,Darmanitan,ICE,105,140,55,30,55,95,480
658,Darmanitan,ICE;FIRE,105,160,55,30,55,135,540
659,Maractus,GRASS,75,86,67,106,67,60,461
660,Dwebble,BUG;ROCK,50,65,85,35,35,55,325
661,Crustle,BUG;ROCK,70,105,125,65,75,45,485
662,Scraggy,DARK;FIGHTING,50,75,70,35,70,48,348
663,Scrafty,DARK;FIGHTING,65,90,115,45,115,58,488
664,Sigilyph,PSYCHIC;FLYING,72,58,80,103,80,97,490
665,Yamask,GHOST,38,30,85,55,65,30,303
666,Yamask,GROUND;GHOST,38,55,85,30,65,30,303
667,Cofagrigus,GHOST,58,50,145,95,105,30,483
668,Tirtouga,WATER;ROCK,54,78,103,53,45,22,355
669,Carracosta,WATER;ROCK,74,108,133,83,65,32,495
670,Archen,ROCK;FLYING,55,112,45,74,45,70,401
671,Archeops,ROCK;FLYING,75,140,65,112,65,110,567
672,Trubbish,POISON,50,50,62,40,62,65,329
673,Garbodor,POISON,80,95,82,60,82,75,474
674,Zorua,DARK,40,65,40,80,40,65,330
675,Zoroark,DARK,60,105,60,120,60,105,510
676,Minccino,NORMAL,55,50,40,40,40,75,300
677,Cinccino,NORMAL,75,95,60,65,60,115,470
678,Gothita,PSYCHIC,45,30,50,55,65,45,290
679,Gothorita,PSYCHIC,60,45,70,75,85,55,390
680,Gothitelle,PSYCHIC,70,55,95,95,110,65,490
681,Solosis,PSYCHIC,45,30,40,105,50,20,290
682,Duosion,PSYCHIC,65,40,50,125,60,30,370
683,Reuniclus,PSYCHIC,110,65,75,125,85,30,490
684,Ducklett,WATER;FLYING,62,44,50,44,50,55,305
685,Swanna,WATER;FLYING,75,87,63,87,63,98,473
686,Vanillite,ICE,36,50,50,65,60,44,305
687,Vanillish,ICE,51,65,65,80,75,59,395
688,Vanilluxe,ICE,71,95,85,110,95,79,535
689,Deerling,NORMAL;GRASS,60,60,50,40,50,75,335
690,Sawsbuck,NORMAL;GRASS,80,100,70,60,70,95,475
691,Emolga,ELECTRIC;FLYING,55,75,60,75,60,103,428
692,Karrablast,BUG,50,75,45,40,45,60,315
693,Escavalier,BUG;STEEL,70,135,105,60,105,20,495
694,Foongus,GRASS;POISON,69,55,45,55,55,15,294
695,Amoonguss,GRASS;POISON,114,85,70,85,80,30,464
696,Frillish,WATER;GHOST,55,40,50,65,85,40,335
697,Jellicent,WATER;GHOST,100,60,70,85,105,60,480
698,Alomomola,WATER,165,75,80,40,45,65,470
699,Joltik,BUG;ELECTRIC,50,47,50,57,50,65,319
700,Galvantula,BUG;ELECTRIC,70,77,60,97,60,108,472
701,Ferroseed,GRASS;STEEL,44,50,91,24,86,10,305
702,Ferrothorn,GRASS;STEEL,74,94,131,54,116,20,489
703,Klink,STEEL,40,55,70,45,60,30,300
704,Klang,STEEL,60,80,95,70,85,50,440
705,Klinklang,STEEL,60,100,115,70,85,90,520
706,Tynamo,ELECTRIC,35,55,40,45,40,60,275
707,Eelektrik,ELECTRIC,65,85,70,75,70,40,405
708,Eelektross,ELECTRIC,85,115,80,105,80,50,515
709,Elgyem,PSYCHIC,55,55,55,85,55,30,335
710,Beheeyem,PSYCHIC,75,75,75,125,95,40,485
711,Litwick,GHOST;FIRE,50,30,55,65,55,20,275
712,Lampent,GHOST;FIRE,60,40,60,95,60,55,370
713,Chandelure,GHOST;FIRE,60,55,90,145,90,80,520
714,Axew,DRAGON,46,87,60,30,40,57,320
715,Fraxure,DRAGON,66,117,70,40,50,67,410
716,Haxorus,DRAGON,76,147,90,60,70,97,540
717,Cubchoo,ICE,55,70,40,60,40,40,305
718,Beartic,ICE,95,130,80,70,80,50,505
719,Cryogonal,ICE,80,50,50,95,135,105,515
720,Shelmet,BUG,50,40,85,40,65,25,305
721,Accelgor,BUG,80,70,40,100,60,145,495
722,Stunfisk,GROUND;ELECTRIC,109,66,84,81,99,32,471
723,Stunfisk,GROUND;STEEL,109,81,99,66,84,32,471
724,Mienfoo,FIGHTING,45,85,50,55,50,65,350
725,Mienshao,FIGHTING,65,125,60,95,60,105,510
726,Druddigon,DRAGON,77,120,90,60,90,48,485
727,Golett,GROUND;GHOST,59,74,50,35,50,35,303
728,Golurk,GROUND;GHOST,89,124,80,55,80,55,483
729,Pawniard,DARK;STEEL,45,85,70,40,40,60,340
730,Bisharp,DARK;STEEL,65,125,100,60,70,70,490
731,Bouffalant,NORMAL,95,110,95,40,95,55,490
732,Rufflet,NORMAL;FLYING,70,83,50,37,50,60,350
733,Braviary,NORMAL;FLYING,100,123,75,57,75,80,510
734,Vullaby,DARK;FLYING,70,55,75,45,65,60,370
735,Mandibuzz,DARK;FLYING,110,65,105,55,95,80,510
736,Heatmor,FIRE,85,97,66,105,66,65,484
737,Durant,BUG;STEEL,58,109,112,48,48,109,484
738,Deino,DARK;DRAGON,52,65,50,45,50,38,300
739,Zweilous,DARK;DRAGON,72,85,70,65,70,58,420
740,Hydreigon,DARK;DRAGON,92,105,90,125,90,98,600
741,Larvesta,BUG;FIRE,55,85,55,50,55,60,360
742,Volcarona,BUG;FIRE,85,60,65,135,105,100,550
743,Cobalion,STEEL;FIGHTING,91,90,129,90,72,108,580
744,Terrakion,ROCK;FIGHTING,91,129,90,72,90,108,580
745,Virizion,GRASS;FIGHTING,91,90,72,90,129,108,580
746,Tornadus,FLYING,79,115,70,125,80,111,580
747,Tornadus,FLYING,79,100,80,110,90,121,580
748,Thundurus,ELECTRIC;FLYING,79,115,70,125,80,111,580
749,Thundurus,ELECTRIC;FLYING,79,105,70,145,80,101,580
750,Reshiram,DRAGON;FIRE,100,120,100,150,120,90,680
751,Zekrom,DRAGON;ELECTRIC,100,150,120,120,100,90,680
752,Landorus,GROUND;FLYING,89,125,90,115,80,101,600
753,Landorus,GROUND;FLYING,89,145,90,105,80,91,600
754,Kyurem,DRAGON;ICE,125,130,90,130,90,95,660
755,Kyurem,DRAGON;ICE,125,170,100,120,90,95,700
756,Kyurem,DRAGON;ICE,125,120,90,170,100,95,700
757,Keldeo,WATER;FIGHTING,91,72,90,129,90,108,580
758,Keldeo,WATER;FIGHTING,91,72,90,129,90,108,580
759,Meloetta,NORMAL;PSYCHIC,100,77,77,128,128,90,600
760,Meloetta,NORMAL;FIGHTING,100,128,90,77,77,128,600
761,Genesect,BUG;STEEL,71,120,95,120,95,99,600
762,Chespin,GRASS,56,61,65,48,45,38,313
763,Quilladin,GRASS,61,78,95,56,58,57,405
764,Chesnaught,GRASS;FIGHTING,88,107,122,74,75,64,530
765,Fennekin,FIRE,40,45,40,62,60,60,307
766,Braixen,FIRE,59,59,58,90,70,73,409
767,Delphox,FIRE;PSYCHIC,75,69,72,114,100,104,534
768,Froakie,WATER,41,56,40,62,44,71,314
769,Frogadier,WATER,54,63,52,83,56,97,405
770,Greninja,WATER;DARK,72,95,67,103,71,122,530
771,Greninja,WATER;DARK,72,145,67,153,71,132,640
772,Bunnelby,NORMAL,38,36,38,32,36,57,237
773,Diggersby,NORMAL;GROUND,85,56,77,50,77,78,423
774,Fletchling,NORMAL;FLYING,45,50,43,40,38,62,278
775,Fletchinder,FIRE;FLYING,62,73,55,56,52,84,382
776,Talonflame,FIRE;FLYING,78,81,71,74,69,126,499
777,Scatterbug,BUG,38,35,40,27,25,35,200
778,Spewpa,BUG,45,22,60,27,30,29,213
779,Vivillon,BUG;FLYING,80,52,50,90,50,89,411
780,Litleo,FIRE;NORMAL,62,50,58,73,54,72,369
781,Pyroar,FIRE;NORMAL,86,68,72,109,66,106,507
782,Flabébé,FAIRY,44,38,39,61,79,42,303
783,Floette,FAIRY,54,45,47,75,98,52,371
784,Florges,FAIRY,78,65,68,112,154,75,552
785,Skiddo,GRASS,66,65,48,62,57,52,350
786,Gogoat,GRASS,123,100,62,97,81,68,531
787,Pancham,FIGHTING,67,82,62,46,48,43,348
788,Pangoro,FIGHTING;DARK,95,124,78,69,71,58,495
789,Furfrou,NORMAL,75,80,60,65,90,102,472
790,Espurr,PSYCHIC,62,48,54,63,60,68,355
791,Meowstic,PSYCHIC,74,48,76,83,81,104,466
792,Meowstic,PSYCHIC,74,48,76,83,81,104,466
793,Honedge,STEEL;GHOST,45,80,100,35,37,28,325
794,Doublade,STEEL;GHOST,59,110,150,45,49,35,448
795,Aegislash,STEEL;GHOST,60,50,140,50,140,60,500
796,Aegislash,STEEL;GHOST,60,140,50,140,50,60,500
797,Spritzee,FAIRY,78,52,60,63,65,23,341
798,Aromatisse,FAIRY,101,72,72,99,89,29,462
799,Swirlix,FAIRY,62,48,66,59,57,49,341
800,Slurpuff,FAIRY,82,80,86,85,75,72,480
801,Inkay,DARK;PSYCHIC,53,54,53,37,46,45,288
802,Malamar,DARK;PSYCHIC,86,92,88,68,75,73,482
803,Binacle,ROCK;WATER,42,52,67,39,56,50,306
804,Barbaracle,ROCK;WATER,72,105,115,54,86,68,500
805,Skrelp,POISON;WATER,50,60,60,60,60,30,320
806,Dragalge,POISON;DRAGON,65,75,90,97,123,44,494
807,Clauncher,WATER,50,53,62,58,63,44,330
808,Clawitzer,WATER,71,73,88,120,89,59,500
809,Helioptile,ELECTRIC;NORMAL,44,38,33,61,43,70,289
810,Heliolisk,ELECTRIC;NORMAL,62,55,52,109,94,109,481
811,Tyrunt,ROCK;DRAGON,58,89,77,45,45,48,362
812,Tyrantrum,ROCK;DRAGON,82,121,119,69,59,71,521
813,Amaura,ROCK;ICE,77,59,50,67,63,46,362
814,Aurorus,ROCK;ICE,123,77,72,99,92,58,521
815,Sylveon,FAIRY,95,65,65,110,130,60,525
816,Hawlucha,FIGHTING;FLYING,78,92,75,74,63,118,500
817,Dedenne,ELECTRIC;FAIRY,67,58,57,81,67,101,431
818,Carbink,ROCK;FAIRY,50,50,150,50,150,50,500
819,Goomy,DRAGON,45,50,35,55,75,40,300
820,Sliggoo,DRAGON,68,75,53,83,113,60,452
821,Goodra,DRAGON,90,100,70,110,150,80,600
822,Klefki,STEEL;FAIRY,57,80,91,80,87,75,470
823,Phantump,GHOST;GRASS,43,70,48,50,60,38,309
824,Trevenant,GHOST;GRASS,85,110,76,65,82,56,474
825,Pumpkaboo,GHOST;GRASS,49,66,70,44,55,51,335
826,Pumpkaboo,GHOST;GRASS,44,66,70,44,55,56,335
827,Pumpkaboo,GHOST;GRASS,54,66,70,44,55,46,335
828,Pumpkaboo,GHOST;GRASS,59,66,70,44,55,41,335
829,Gourgeist,GHOST;GRASS,65,90,122,58,75,84,494
830,Gourgeist,GHOST;GRASS,55,85,122,58,75,99,494
831,Gourgeist,GHOST;GRASS,75,95,122,58,75,69,494
832,Gourgeist,GHOST;GRASS,85,100,122,58,75,54,494
833,Bergmite,ICE,55,69,85,32,35,28,304
834,Avalugg,ICE,95,117,184,44,46,28,514
835,Noibat,FLYING;DRAGON,40,30,35,45,40,55,245
836,Noivern,FLYING;DRAGON,85,70,80,97,80,123,535
837,Xerneas,FAIRY,126,131,95,131,98,99,680
838,Yveltal,DARK;FLYING,126,131,95,131,98,99,680
839,Zygarde,DRAGON;GROUND,108,100,121,81,95,95,600
840,Zygarde,DRAGON;GROUND,54,100,71,61,85,115,486
841,Zygarde,DRAGON;GROUND,216,100,121,91,95,85,708
842,Diancie,ROCK;FAIRY,50,100,150,100,150,50,600
843,Diancie,ROCK;FAIRY,50,160,110,160,110,110,700
844,Hoopa,PSYCHIC;GHOST,80,110,60,150,130,70,600
845,Hoopa,PSYCHIC;DARK,80,160,60,170,130,80,680
846,Volcanion,FIRE;WATER,80,110,120,130,90,70,600
847,Rowlet,GRASS;FLYING,68,55,55,50,50,42,320
848,Dartrix,GRASS;FLYING,78,75,75,70,70,52,420
849,Decidueye,GRASS;GHOST,78,107,75,100,100,70,530
850,Litten,FIRE,45,65,40,60,40,70,320
851,Torracat,FIRE,65,85,50,80,50,90,420
852,Incineroar,FIRE;DARK,95,115,90,80,90,60,530
853,Popplio,WATER,50,54,54,66,56,40,320
854,Brionne,WATER,60,69,69,91,81,50,420
855,Primarina,WATER;FAIRY,80,74,74,126,116,60,530
856,Pikipek,NORMAL;FLYING,35,75,30,30,30,65,265
857,Trumbeak,NORMAL;FLYING,55,85,50,40,50,75,355
858,Toucannon,NORMAL;FLYING,80,120,75,75,75,60,485
859,Yungoos,NORMAL,48,70,30,30,30,45,253
860,Gumshoos,NORMAL,88,110,60,55,60,45,418
861,Grubbin,BUG,47,62,45,55,45,46,300
862,Charjabug,BUG;ELECTRIC,57,82,95,55,75,36,400
863,Vikavolt,BUG;ELECTRIC,77,70,90,145,75,43,500
864,Crabrawler,FIGHTING,47,82,57,42,47,63,338
865,Crabominable,FIGHTING;ICE,97,132,77,62,67,43,478
866,Oricorio,FIRE;FLYING,75,70,70,98,70,93,476
867,Oricorio,ELECTRIC;FLYING,75,70,70,98,70,93,476
868,Oricorio,PSYCHIC;FLYING,75,70,70,98,70,93,476
869,Oricorio,GHOST;FLYING,75,70,70,98,70,93,476
870,Cutiefly,BUG;FAIRY,40,45,40,55,40,84,304
871,Ribombee,BUG;FAIRY,60,55,60,95,70,124,464
872,Rockruff,ROCK,45,65,40,30,40,60,280
873,Rockruff,ROCK,45,65,40,30,40,60,280
874,Lycanroc,ROCK,75,115,65,55,65,112,487
875,Lycanroc,ROCK,85,115,75,55,75,82,487
876,Lycanroc,ROCK,75,117,65,55,65,110,487
877,Wishiwashi,WATER,45,20,20,25,25,40,175
878,Wishiwashi,WATER,45,140,130,140,135,30,620
879,Mareanie,POISON;WATER,50,53,62,43,52,45,305
880,Toxapex,POISON;WATER,50,63,152,53,142,35,495
881,Mudbray,GROUND,70,100,70,45,55,45,385
882,Mudsdale,GROUND,100,125,100,55,85,35,500
883,Dewpider,WATER;BUG,38,40,52,40,72,27,269
884,Araquanid,WATER;BUG,68,70,92,50,132,42,454
885,Fomantis,GRASS,40,55,35,50,35,35,250
886,Lurantis,GRASS,70,105,90,80,90,45,480
887,Morelull,GRASS;FAIRY,40,35,55,65,75,15,285
888,Shiinotic,GRASS;FAIRY,60,45,80,90,100,30,405
889,Salandit,POISON;FIRE,48,44,40,71,40,77,320
890,Salazzle,POISON;FIRE,68,64,60,111,60,117,480
891,Stufful,NORMAL;FIGHTING,70,75,50,45,50,50,340
892,Bewear,NORMAL;FIGHTING,120,125,80,55,60,60,500
893,Bounsweet,GRASS,42,30,38,30,38,32,210
894,Steenee,GRASS,52,40,48,40,48,62,290
895,Tsareena,GRASS,72,120,98,50,98,72,510
896,Comfey,FAIRY,51,52,90,82,110,100,485
897,Oranguru,NORMAL;PSYCHIC,90,60,80,90,110,60,490
898,Passimian,FIGHTING,100,120,90,40,60,80,490
899,Wimpod,BUG;WATER,25,35,40,20,30,80,230
900,Golisopod,BUG;WATER,75,125,140,60,90,40,530
901,Sandygast,GHOST;GROUND,55,55,80,70,45,15,320
902,Palossand,GHOST;GROUND,85,75,110,100,75,35,480
903,Pyukumuku,WATER,55,60,130,30,130,5,410
904,Type: Null,NORMAL,95,95,95,95,95,59,534
905,Silvally,NORMAL,95,95,95,95,95,95,570
906,Minior,ROCK;FLYING,60,60,100,60,100,60,440
907,Minior,ROCK;FLYING,60,100,60,100,60,120,500
908,Komala,NORMAL,65,115,65,75,95,65,480
909,Turtonator,FIRE;DRAGON,60,78,135,91,85,36,485
910,Togedemaru,ELECTRIC;STEEL,65,98,63,40,73,96,435
911,Mimikyu,GHOST;FAIRY,55,90,80,50,105,96,476
912,Bruxish,WATER;PSYCHIC,68,105,70,70,70,92,475
913,Drampa,NORMAL;DRAGON,78,60,85,135,91,36,485
914,Dhelmise,GHOST;GRASS,70,131,100,86,90,40,517
915,Jangmo-o,DRAGON,45,55,65,45,45,45,300
916,Hakamo-o,DRAGON;FIGHTING,55,75,90,65,70,65,420
917,Kommo-o,DRAGON;FIGHTING,75,110,125,100,105,85,600
918,Tapu Koko,ELECTRIC;FAIRY,70,115,85,95,75,130,570
919,Tapu Lele,PSYCHIC;FAIRY,70,85,75,130,115,95,570
920,Tapu Bulu,GRASS;FAIRY,70,130,115,85,95,75,570
921,Tapu Fini,WATER;FAIRY,70,75,115,95,130,85,570
922,Cosmog,PSYCHIC,43,29,31,29,31,37,200
923,Cosmoem,PSYCHIC,43,29,131,29,131,37,400
924,Solgaleo,PSYCHIC;STEEL,137,137,107,113,89,97,680
925,Lunala,PSYCHIC;GHOST,137,113,89,137,107,97,680
926,Nihilego,ROCK;POISON,109,53,47,127,131,103,570
927,Buzzwole,BUG;FIGHTING,107,139,139,53,53,79,570
928,Pheromosa,BUG;FIGHTING,71,137,37,137,37,151,570
929,Xurkitree,ELECTRIC,83,89,71,173,71,83,570
930,Celesteela,STEEL;FLYING,97,101,103,107,101,61,570
931,Kartana,GRASS;STEEL,59,181,131,59,31,109,570
932,Guzzlord,DARK;DRAGON,223,101,53,97,53,43,570
933,Necrozma,PSYCHIC,97,107,101,127,89,79,600
934,Necrozma,PSYCHIC;STEEL,97,157,127,113,109,77,680
935,Necrozma,PSYCHIC;GHOST,97,113,109,157,127,77,680
936,Necrozma,PSYCHIC;DRAGON,97,167,97,167,97,129,754
937,Magearna,STEEL;FAIRY,80,95,115,130,115,65,600
938,Marshadow,FIGHTING;GHOST,90,125,80,90,90,125,600
939,Poipole,POISON,67,73,67,73,67,73,420
940,Naganadel,POISON;DRAGON,73,73,73,127,73,121,540
941,Stakataka,ROCK;STEEL,61,131,211,53,101,13,570
942,Blacephalon,FIRE;GHOST,53,127,53,151,79,107,570
943,Zeraora,ELECTRIC,88,112,75,102,80,143,600
944,Meltan,STEEL,46,65,65,55,35,34,300
945,Melmetal,STEEL,135,143,143,80,65,34,600
946,Grookey,GRASS,50,65,50,40,40,65,310
947,Thwackey,GRASS,70,85,70,55,60,80,420
948,Rillaboom,GRASS,100,125,90,60,70,85,530
949,Scorbunny,FIRE,50,71,40,40,40,69,310
950,Raboot,FIRE,65,86,60,55,60,94,420
951,Cinderace,FIRE,80,116,75,65,75,119,530
952,Sobble,WATER,50,40,40,70,40,70,310
953,Drizzile,WATER,65,60,55,95,55,90,420
954,Inteleon,WATER,70,85,65,125,65,120,530
955,Skwovet,NORMAL,70,55,55,35,35,25,275
956,Greedent,NORMAL,120,95,95,55,75,20,460
957,Rookidee,FLYING,38,47,35,33,35,57,245
958,Corvisquire,FLYING,68,67,55,43,55,77,365
959,Corviknight,FLYING;STEEL,98,87,105,53,85,67,495
960,Blipbug,BUG,25,20,20,25,45,45,180
961,Dottler,BUG;PSYCHIC,50,35,80,50,90,30,335
962,Orbeetle,BUG;PSYCHIC,60,45,110,80,120,90,505
963,Nickit,DARK,40,28,28,47,52,50,245
964,Thievul,DARK,70,58,58,87,92,90,455
965,Gossifleur,GRASS,40,40,60,40,60,10,250
966,Eldegoss,GRASS,60,50,90,80,120,60,460
967,Wooloo,NORMAL,42,40,55,40,45,48,270
968,Dubwool,NORMAL,72,80,100,60,90,88,490
969,Chewtle,WATER,50,64,50,38,38,44,284
970,Drednaw,WATER;ROCK,90,115,90,48,68,74,485
971,Yamper,ELECTRIC,59,45,50,40,50,26,270
972,Boltund,ELECTRIC,69,90,60,90,60,121,490
973,Rolycoly,ROCK,30,40,50,40,50,30,240
974,Carkol,ROCK;FIRE,80,60,90,60,70,50,410
975,Coalossal,ROCK;FIRE,110,80,120,80,90,30,510
976,Applin,GRASS;DRAGON,40,40,80,40,40,20,260
977,Flapple,GRASS;DRAGON,70,110,80,95,60,70,485
978,Appletun,GRASS;DRAGON,110,85,80,100,80,30,485
979,Silicobra,GROUND,52,57,75,35,50,46,315
980,Sandaconda,GROUND,72,107,125,65,70,71,510
981,Cramorant,FLYING;WATER,70,85,55,85,95,85,475
982,Arrokuda,WATER,41,63,40,40,30,66,280
983,Barraskewda,WATER,61,123,60,60,50,136,490
984,Toxel,ELECTRIC;POISON,40,38,35,54,35,40,242
985,Toxtricity,ELECTRIC;POISON,75,98,70,114,70,75,502
986,Toxtricity,ELECTRIC;POISON,75,98,70,114,70,75,502
987,Sizzlipede,FIRE;BUG,50,65,45,50,50,45,305
988,Centiskorch,FIRE;BUG,100,115,65,90,90,65,525
989,Clobbopus,FIGHTING,50,68,60,50,50,32,310
990,Grapploct,FIGHTING,80,118,90,70,80,42,480
991,Sinistea,GHOST,40,45,45,74,54,50,308
992,Polteageist,GHOST,60,65,65,134,114,70,508
993,Hatenna,PSYCHIC,42,30,45,56,53,39,265
994,Hattrem,PSYCHIC,57,40,65,86,73,49,370
995,Hatterene,PSYCHIC;FAIRY,57,90,95,136,103,29,510
996,Impidimp,DARK;FAIRY,45,45,30,55,40,50,265
997,Morgrem,DARK;FAIRY,65,60,45,75,55,70,370
998,Grimmsnarl,DARK;FAIRY,95,120,65,95,75,60,510
999,Obstagoon,DARK;NORMAL,93,90,101,60,81,95,520
1000,Perrserker,STEEL,70,110,100,50,60,50,440
1001,Cursola,GHOST,60,95,50,145,130,30,510
1002,Sirfetch'd,FIGHTING,62,135,95,68,82,65,507
1003,Mr. Rime,PSYCHIC;ICE,80,85,75,110,100,70,520
1004,Runerigus,GROUND;GHOST,58,95,145,50,105,30,483
1005,Milcery,FAIRY,45,40,40,50,61,34,270
1006,Alcremie,FAIRY,65,60,75,110,121,64,495
1007,Falinks,FIGHTING,65,100,100,70,60,75,470
1008,Pincurchin,ELECTRIC,48,101,95,91,85,15,435
1009,Snom,ICE;BUG,30,25,35,45,30,20,185
1010,Frosmoth,ICE;BUG,70,65,60,125,90,65,475
1011,Stonjourner,ROCK,100,125,135,20,20,70,470
1012,Eiscue,ICE,75,80,110,65,90,50,470
1013,Eiscue,ICE,75,80,70,65,50,130,470
1014,Indeedee,PSYCHIC;NORMAL,60,65,55,105,95,95,475
1015,Indeedee,PSYCHIC;NORMAL,70,55,65,95,105,85,475
1016,Morpeko,ELECTRIC;DARK,58,95,58,70,58,97,436
1017,Morpeko,ELECTRIC;DARK,58,95,58,70,58,97,436
1018,Cufant,STEEL,72,80,49,40,49,40,330
1019,Copperajah,STEEL,122,130,69,80,69,30,500
1020,Dracozolt,ELECTRIC;DRAGON,90,100,90,80,70,75,505
1021,Arctozolt,ELECTRIC;ICE,90,100,90,90,80,55,505
1022,Dracovish,WATER;DRAGON,90,90,100,70,80,75,505
1023,Arctovish,WATER;ICE,90,90,100,80,90,55,505
1024,Duraludon,STEEL;DRAGON,70,95,115,120,50,85,535
1025,Dreepy,DRAGON;GHOST,28,60,30,40,30,82,270
1026,Drakloak,DRAGON;GHOST,68,80,50,60,50,102,410
1027,Dragapult,DRAGON;GHOST,88,120,75,100,75,142,600
1028,Zacian,FAIRY;STEEL,92,170,115,80,115,148,720
1029,Zacian,FAIRY,92,130,115,80,115,138,670
1030,Zamazenta,FIGHTING;STEEL,92,130,145,80,145,128,720
1031,Zamazenta,FIGHTING,92,130,115,80,115,138,670
1032,Eternatus,POISON;DRAGON,140,85,95,145,95,130,690
1033,Eternatus,POISON;DRAGON,255,115,250,125,250,130,1125
1034,Kubfu,FIGHTING,60,90,60,53,50,72,385
1035,Urshifu,FIGHTING;DARK,100,130,100,63,60,97,550
1036,Urshifu,FIGHTING;WATER,100,130,100,63,60,97,550
1037,Zarude,DARK;GRASS,105,120,105,70,95,105,600
1038,Regieleki,ELECTRIC,80,100,50,100,50,200,580
1039,Regidrago,DRAGON,200,100,50,100,50,80,580
1040,Glastrier,ICE,100,145,130,65,110,30,580
1041,Spectrier,GHOST,100,65,60,145,80,130,580
1042,Calyrex,PSYCHIC;GRASS,100,80,80,80,80,80,500
1043,Calyrex,PSYCHIC;ICE,100,165,150,85,130,50,680
1044,Calyrex,PSYCHIC;GHOST,100,85,80,165,100,150,680
